Gene.refGene	TYPE
AKT3	ONCOGENE
ANK3	ONCOGENE
APC	TSG
ATM	TSG
ATRX	TSG
BRAF	SMG
CTNNB1	ONCOGENE
FGFR2	ONCOGENE
HRAS	ONCOGENE
KIT	ONCOGENE
KMT2B	TSG
KMT2C	TSG
KMT2D	TSG
KRAS	ONCOGENE
MAP2K1	ONCOGENE
NF1	TSG
NOTCH2	TSG
NRAS	SMG
PTEN	TSG
RAC1	ONCOGENE
RAF1	ONCOGENE
TP53	TSG
TYRP1	TSG